1111111111111
1000000000001
100111C111001
10C10101C1001
10P10111C1111
1000000000E01
1111111111111
