1111111111111
0001S00C00C01
1000011111001
1P0011C00E000
1111111111111
