1111111111111
1001C00C00C01
1000011111001
100011C0E0001
1111111111111
