1111111111111
1001S00C00C01
1000011111001
1P0011C00E001
1111111111111
