1111111111111
1001C00C00C01
1000011111001
1P0011C00E001
11111111111
